%%%%%%
%   .%
%P.% %
%.  .%
%%%%%%