%%%%%%
%   .%
% .%P%
%.  .%
%%%%%%