%%%%%%
%P...%
% %% %
% .  %
%.. .%
%%%%%%