%%%%%%%
%P..  %
% %% .%
%  .  %
%. %% %
%..   %
%%%%%%%