%%%%%%%%
%P..   %
% %% . %
%    % %
%. %%  %
%  . . %
% .    %
%%%%%%%%