%%%%%%%%%
%P..    %
% %% .  %
%    %  %
%. %%   %
%  . .  %
% .   % %
%       %
%%%%%%%%%