%%%%%%%%%%%%%%%
%P...%.....%..%
%.%%.%.%%%.%.%%
%.%..........%
%.%.%%%.%%%.%.%
%o..%.....%..o%
%%%.%.%%%.%.%%%
%...%..G..%...%
%.%%%%.%.%%%%.%
%............G%
%%%%%%%%%%%%%%%
