%%%%%%%%
%P . . %
%..%.  %
% . % .%
% ....%%
%  . . %
%.   %.%
%%%%%%%%
