%%%%%%%%%
%P..%...%
%.%.%.%.%
%.%...%.%
%.%%%.%.%
%o....%G%
%%%%%%%%%
