%%%%%%%%
%P . . %
%. %   %
%   % .%
%     %%
%      %
%    %.%
%%%%%%%%
