%%%%%
%P .%
%.  %
%.  %
%%%%%
